*************
*#*###*******
*#***********
*###*********
*************
*************
*************
*************
*************
*************
*************
*****$$$*****
*****$*$*****
